#################
#    ###    #   #
# @  #     ##   #
#    #    #     #
#### ## #####   #
#     #     #   #
#     #         #
#### #### #######
#               #
#################
